17 17 15.5 12.5
1 1 1 1 1 1 1 1 1 1 1 1 1 1 1 1 1
1 0 3 4 3 3 4 3 3 0 5 5 5 5 5 0 0
1 0 3 0 0 0 0 0 0 5 0 0 0 0 0 5 0
1 0 3 0 0 0 0 0 0 0 0 0 0 5 0 5 0
1 0 4 0 0 0 0 0 0 5 0 0 0 0 0 5 0
1 0 4 0 0 0 3 3 4 0 5 5 0 5 5 0 0
1 0 3 0 0 0 4 0 0 0 2 0 0 0 2 0 0
1 0 3 0 0 0 3 0 0 0 1 0 0 0 1 0 0
1 0 4 3 4 3 3 0 0 0 2 0 0 0 2 0 0
1 0 0 0 0 0 0 0 0 2 0 0 0 0 0 2 0
1 0 0 0 0 2 1 2 2 0 0 0 0 0 0 0 2
1 0 0 0 2 0 0 0 2 0 0 0 0 0 0 0 2
1 0 0 0 1 0 0 0 0 0 0 0 0 0 0 0 1
1 0 0 0 2 0 0 0 2 0 0 0 0 0 0 0 2
1 0 0 0 0 2 1 2 2 0 0 0 0 0 0 0 2
1 0 0 0 0 0 0 0 1 2 0 0 0 0 0 2 1
1 1 1 1 1 1 1 1 1 1 2 2 1 2 2 1 1

15.5 10.5 7
15.5 14.5 7
14.5 9.5 7
14.5 15.5 7
10.5 9.5 7
10.5 15.5 7
9.5 10.5 7
9.5 14.5 7

11.5 6.5 6
11.3 7 6
11.3 6 6
13.5 5.5 6

6.3 11.8 6
6.8 11.3 6

2.5 3.5 7
2.5 8.5 7
4.5 8.5 7
7.5 3.5 7
7.5 5.5 7

12.5 6.5 8
12.5 12.5 8
7.5 12.5 8
3.5 14.5 8
3.5 10.5 8
3.5 4.5 8